#####
#   #
# #$####
#   ...#
##$#  @#
 # ## ##
## $  #
#  ## #
#   # #
#     #
#######