##########
#        #
#@  $    #
#  $.   .#
#   $.   #
#        #
##########