 #######
##     ##
#  .$.  #
# #$*$#@#
# #.$.  #
#  # ####
##   #
 #####