##############   ####
#@     $    .#####. #
###########       $##
          #        #
          ##########