   ########
 ###      ###       
 #   ####   ###     
 # ###  ###.  ##### 
 # # **  ##$* #   # 
## #   * ##.$   .$##
#. $*  *  #@* # $. #
#### *    #*  # ## #
   ## ****# * #    #
    ##  * **  ######
     ##       #     
      #########  