     ######
     #    #
     #$## #
     # ## #
######.## #
#    $ #. #
#         #
#  ####.  #
# @$  ## ##
#        #
##########